1,1,2,1,0,0,0,0
1,1,6,1,0,0,0,0
1,1,0,0,0,0,0,0
1,4,0,0,0,0,0,0
1,5,0,0,0,0,0,0
1,6,0,0,0,0,0,0
1,7,0,0,0,0,0,0
1,8,0,0,0,0,0,0
1,9,0,0,0,0,0,0
1,10,2,1,0,0,0,0,0,0
1,11,2,2,0,0,0,0,0,0
1,12,2,3,0,0,0,0,0,0
1,13,2,4,0,0,0,0,0,0
1,14,2,5,0,0,0,0,0,0
1,15,2,6,0,0,0,0,0,0
1,16,2,7,0,0,0,0,0,0
1,17,2,8,0,0,0,0,0,0
1,18,2,9,0,0,0,0,0,0
1,19,2,10,0,0,0,0,0,0
1,20,2,11,3,1,0,0,0,0
